transaction,amount,balance
,,-50.0
deposit,30.0,-20.0
withdrawal,-45.0,-65.0
deposit,100.0,35.0
withdrawal,-13.22,21.78
deposit,149.0,170.78
